ALA	= "countries/Alamania.txt"
BAT	= "countries/Bataj.txt"
BEF = "countries/Befglorta.txt"
BOT = "countries/Botrelia.txt"
CHE = "countries/Chernaria.txt"
DES = "countries/Desunion.txt"
DUR = "countries/Durtie.txt"
EIR = "countries/Eirie.txt"
ESP = "countries/Espia.txt"
EUR = "countries/Eurada.txt"
EVO = "countries/Evolia.txt"
FED = "countries/Fedvic.txt"
GEN = "countries/Gensokyo.txt"
GES = "countries/Gesie.txt"
HER = "countries/Hervic.txt"
HEY = "countries/Heydra.txt"
LEG = "countries/Legatia.txt"
LIK = "countries/Likoshen.txt"
NAB = "countries/Nabic.txt"
NAG = "countries/Nagijix.txt"
NER = "countries/Nerjo.txt"
NEV = "countries/Nevse.txt"
OYO = "countries/Oyorri.txt"
PES = "countries/Pestfriland.txt"
POL = "countries/Polishlith.txt"
REG = "countries/Regia.txt"
TER = "countries/Teriko.txt"
GEL = "countries/Gerolstein.txt"
KOR = "countries/Korvenia.txt"
RSL = "countries/RuslawConfed.txt"